ОТЧЕТ ОБ УДАЛЕНИИ ТЕХНИК
==================================================

Было техник: 3377
Удалено: 387
Осталось: 2990

УДАЛЕННЫЕ ТЕХНИКИ ПО КАТЕГОРИЯМ:

[simple_elemental]
  水球 → Водный Шар

[generic_combat]
  踏剑飞行 → Полет на Мече

[simple_elemental]
  风刃 → Ветряное Лезвие / Клинок Ветра
  火蛇 → Огненная Змея (как проявление/атака)
  雾蛇 → Туманная Змея
  雨箭 → Дождевые Стрелы
  火蟒 → Огненный Питон

[color_variations]
  紫色的旋风 → Пурпурный Вихрь

[simple_elemental]
  剑雨 → Мечевой Дождь

[short_generic]
  水膜 → Водная Пленка
  乱剑 → Хаотичные Мечи

[generic_combat]
  暗击 → Скрытая Атака

[simple_elemental]
  光柱 → Световой Столб

[short_generic]
  狼烟 → Волчий Дым

[simple_elemental]
  火球 → Огненный Шар
  雷球 → Громовой Шар

[short_generic]
  封斩 → Запечатать и Рассечь
  紫龙 → Пурпурный Дракон
  剑漩 → Мечевой Вихрь
  三阵 → Три Формации
  火龙 → Огненный Дракон
  血指 → Кровавый Палец
  挪移 → Перемещение/Телепортация

[simple_physical]
  一指 → Удар Одним Пальцем

[short_generic]
  彩云 → Разноцветное Облако
  剑芒 → Сияние Меча
  祭剑 → Жертвоприношение Меча

[simple_physical]
  隔空一拍 → Удар Ладонью Сквозь Пространство

[numbered_strikes]
  五拍一罗 → Пять Ударов, Одно Окружение

[short_generic]
  毒指 → Ядовитый Палец
  剑龙 → Мечевой Дракон

[numbered_strikes]
  青罗五拍 → Пять Ударов Лазурной Ро

[short_generic]
  催化 → Катализация / Ускорение (как техника)
  瞬移 → Мгновенное Перемещение / Телепортация
  雷爆 → Громовой Взрыв
  蛟影 → Тень Цзяо
  传音 → Передача Звука
  无面 → Безликий (как название техники)
  一言 → Одно Слово (как техника/команда)
  三拳 → Три Удара Кулаком
  黄光 → Желтый Свет
  瞒天 → Обман Небес
  祭炼 → Жертвоприношение и Очищение
  黑雨 → Черный Дождь

[generic_combat]
  防护风暴 → Защитный Шторм

[short_generic]
  雷法 → Техника Грома
  雷刃 → Громовое Лезвие
  骨球 → Костяной Шар

[color_variations]
  黑色的风暴 → Черный Шторм

[short_generic]
  音爆 → Звуковой Удар

[generic_combat]
  金色光幕 → Золотой Световой Барьер

[short_generic]
  空崩 → Пустотный Коллапс
  刺球 → Колючий Шар
  金钟 → Золотой Колокол
  金身 → Золотое Тело
  金雕 → Золотой Орел
  绞杀 → Удушение / Удушающая атака
  掐诀 → Формирование Ручной Печати
  遁走 → Уход/Побег (техника движения)
  酒风 → Винный Ветер
  剑魂 → Душа Меча
  黑月 → Черная Луна
  识杀 → Убийство Сознанием

[generic_combat]
  八脉反击 → Контратака Восьми Меридианов

[short_generic]
  开阵 → Открытие Формации
  残云 → Остаточные Облака
  裂云 → Разрывающие Облака
  雾手 → Туманная Рука
  血雨 → Кровавый Дождь
  布阵 → Развертывание Формации
  血遁 → Кровавый Побег

[generic_combat]
  防护光幕 → Защитный Световой Барьер

[simple_physical]
  风沙防护 → Защита Ветряным Песком

[generic_combat]
  崩溃爆开 → Коллапс и Взрыв

[short_generic]
  血杀 → Кровавое Убийство
  疗伤 → Лечение Ран
  风字 → Иероглиф Ветра (как техника)
  绝杀 → Смертельный Удар
  观山 → Наблюдение за Горой
  强推 → Принудительное Продвижение

[generic_combat]
  一圈落下 → Один Удар Кулаком Опускается

[short_generic]
  银蛇 → Серебряные Змеи
  匹练 → Лента/Полотно
  摄魂 → Захват Души
  斩灭 → Рассечение и Уничтожение
  火雨 → Огненный Дождь
  内视 → Внутреннее Зрение
  残阳 → Заходящее Солнце
  摄出 → Извлечение/Вытягивание
  破空 → Прорыв Сквозь Пустоту

[numbered_strikes]
  斩灵第二刀 → Второй Удар Рассечения Духа

[short_generic]
  一拜 → Один Поклон
  鹿头 → Голова Оленя (как проявление/техника)
  鹿角 → Оленьи Рога (как проявление/техника)
  鹿身 → Тело Оленя (как проявление/техника)
  巨鹿 → Гигантский Олень (как проявление/техника)
  白虎 → Белый Тигр (как проявление/техника)
  逃遁 → Техника Побега
  法雨 → Дождь Законов
  一吼 → Один Рев

[generic_combat]
  一斩 → Один Удар/Рассечение

[short_generic]
  破阵 → Прорыв Формации
  雾剑 → Туманный Меч

[generic_combat]
  一拳 → Один Удар Кулаком

[simple_physical]
  一脚落下 → Удар Ногой

[short_generic]
  遮天 → Заслонить Небеса
  坑杀 → Убить Обманом / Захоронить Заживо
  斩鬼 → Убийство Призраков
  一吸 → Одно Всасывание (техника Мэн Хао)
  吞鬼 → Поглощение Призраков

[simple_physical]
  一掌拍去 → Удар Ладонью

[short_generic]
  开天 → Открытие Небес

[simple_physical]
  一枪而去 → Удар Копьем

[short_generic]
  爪痕 → Коготь (как техника/проявление)
  阻杀 → Преградить и Убить
  钻身 → Проникновение/Проскальзывание
  移形 → Смена Формы
  藤影 → Тень Лозы

[simple_physical]
  一脚横扫 → Удар Ногой с Разворота

[short_generic]
  改命 → Изменение Судьбы
  金虹 → Золотая Радуга (как проявление техники)
  赤鹏 → Алый Пэн
  炸雷 → Взрывной Гром (как тип ловушки/атаки)
  内斗 → Внутренняя борьба (как действие, спровоцированное)

[generic_combat]
  两世一拳 → Один Удар Кулаком Двух Поколений

[short_generic]
  连灭 → Последовательное Уничтожение
  降灵 → Нисхождение Духа
  吞天 → Поглощение Небес
  黑夜 → Черная Ночь
  法眼 → Око Дхармы

[generic_combat]
  一拳过去 → Один Удар Кулаком
  再次一拳 → Снова Один Удар Кулаком

[numbered_strikes]
  第二拳 → Второй Удар Кулаком

[generic_combat]
  一拳惊艳 → Потрясающий Один Удар Кулаком

[short_generic]
  火口 → Огненная Пасть

[simple_physical]
  一脚踢去 → Удар ногой

[short_generic]
  生擒 → Захват Живьем

[simple_physical]
  闪躲 → Уклонение

[short_generic]
  邪字 → Иероглиф "Зло" (как техника)

[simple_physical]
  一拳轰去 → Ударить Кулаком

[short_generic]
  冲击 → Атаковать / Ударять
  困住 → Запереть / Захватить
  锁定 → Зафиксировать / Заблокировать
  强闯 → Силовой Прорыв
  开坛 → Открытие Алтаря (для обучения)

[simple_physical]
  敲响丹阁之鼓 → Ударить в Барабан Павильона Пилюль

[short_generic]
  震散 → Рассеять Сотрясением
  捏碎 → Раздавить / Размять
  拔刀 → Выхватить Клинок
  升空 → Поднятие в Воздух
  遮盖 → Заслонение/Покрытие
  光球 → Световой Шар
  踏入 → Вступить / Войти
  抢到 → Захватить / Заполучить
  一按 → Одно Нажатие

[simple_physical]
  一拳拳落下 → Удары Кулаком, Падающие Один за Другим

[short_generic]
  虚握 → Хватка в Пустоте
  青龙 → Лазурный Дракон (как проявление техники)
  碎虚 → Разрушение Пустоты

[simple_physical]
  虚空一指 → Удар Одним Пальцем Сквозь Пространство

[short_generic]
  冷笑 → Холодная Улыбка
  出手 → Сделать Ход/Атаковать
  联手 → Объединить Усилия
  杀向 → Устремиться Убивать
  凝望 → Пристально Смотреть
  解散 → Распустить / Разогнать
  怒吼 → Яростный Рев
  分离 → Разделение (как техника/действие)
  逃婚 → Побег со Свадьбы
  撒欢 → Беситься / Нестись
  惯空 → Пронзание Пустоты
  奔雷 → Стремительный Гром
  杀入 → Вторжение с Убийством

[simple_physical]
  隔空一击 → Удар сквозь пространство

[short_generic]
  拜见 → Поклониться в Приветствии
  解围 → Разрешить Затруднение

[simple_physical]
  击击杀意 → Удар за Ударом, Убийственное Намерение

[short_generic]
  强杀 → Принудительное Убийство
  拳法 → Кулачная Техника
  煮海 → Кипячение Моря
  镇死 → Подавление до Смерти
  吸走 → Отсосать / Поглотить
  抬头 → Поднять Голову
  呼吼 → Реветь / Громко Кричать
  豁开 → Раскрыть / Разверзнуть
  散出 → Излучать / Распространять
  逃入 → Сбежать в / Укрыться в
  攀升 → Подниматься / Восходить
  漂浮 → Плавать / Дрейфовать
  烫死 → Ошпарить до Смерти
  海墙 → Морская Стена
  浮现 → Появление / Проявление
  牵制 → Сдерживать / Отвлекать
  屠杀 → Резня / Массовое Убийство
  绝了 → Оборвать / Уничтожить
  取出 → Извлечь / Вынуть
  压缩 → Сжимать / Компрессировать
  一压 → Надавить / Подавить
  挣扎 → Бороться / Сопротивляться
  扣入 → Вцепиться в / Вдавить в
  一抖 → Встряхнуть / Сотрясти
  困杀 → Запереть и Убить
  冲杀 → Броситься в Бой и Убивать
  血甲 → Кровавые Доспехи

[simple_physical]
  冲击横扫 → Ударный Сметающий Прием
  大地一砸 → Удар по Земле

[short_generic]
  指风 → Пальцевый Ветер
  长笑 → Громко Смеяться
  抹去 → Стереть / Удалить
  杀去 → Устремиться Убивать
  冲去 → Броситься/Устремиться
  仰天 → Запрокинуть Голову
  时止 → Остановка Времени

[generic_combat]
  一拳灭生 → Один Удар Кулаком Уничтожает Жизнь
  一拳入魔 → Один Удар Кулаком Вхождение в Демонизм

[short_generic]
  震开 → Отбросить Сотрясением

[generic_combat]
  化作了一道青色的光幕 → Превратиться в Лазурный Световой Барьер

[short_generic]
  掐住 → Схватить за Горло
  轰退 → Отбросить Взрывом

[numbered_strikes]
  第四拳 → Четвертый Удар Кулаком

[short_generic]
  封法 → Запечатывание Закона

[simple_physical]
  兽爪一击 → Удар Когтем Зверя

[short_generic]
  飞花 → Летящие Цветы
  三杀 → Три Убийства
  大脚 → Большая Нога (проявление техники)
  双拳 → Два Кулака
  光河 → Световая Река
  血图 → Кровавая Картина
  叠踩 → Наступать Друг на Друга (о ногах)
  展翅 → Расправить Крылья

[generic_combat]
  杀神一拳 → Кулак Бога Убийства (один удар)

[short_generic]
  割脉 → Перерезание Вен
  倒卷 → Откатиться / Свернуться Назад
  刺向 → Пронзить В Направлении
  冷哼 → Холодный Вздох

[simple_physical]
  一拳轰击 → Удар Кулаком

[color_variations]
  紫色的手掌 → Пурпурная Ладонь

[short_generic]
  火环 → Огненное Кольцо
  逞强 → Демонстрация Силы
  堵死 → Полностью Заблокировать
  召回 → Отозвать / Вернуть
  屠灭 → Уничтожение (полное)
  求来 → Призвать/Выпросить
  青鹏 → Лазурный Пэн
  破界 → Прорыв Царства
  盯着 → Пристально Смотреть
  低声 → Тихим Голосом
  大喝 → Громкий Крик
  献给 → Посвятить/Преподнести
  大吼 → Громкий Рев
  操控 → Управление / Манипуляция
  伸开 → Раскрыть / Вытянуть
  握住 → Схватить / Удерживать
  没入 → Погрузиться / Проникнуть
  息怒 → Успокоить Гнев
  求情 → Просить о Пощаде / Заступаться
  激发 → Активировать / Стимулировать

[generic_combat]
  一刀 → Один Удар Клинком

[short_generic]
  收起 → Убрать
  一挥 → Один Взмах
  迈出 → Сделать Шаг
  阳爆 → Взрыв Ян
  挑动 → Спровоцировать
  传令 → Отдать Приказ
  封死 → Полностью запечатать
  膨胀 → Раздуваться / Расширяться
  缩小 → Сжиматься / Уменьшаться
  摇头 → Качать Головой
  脱身 → Избавиться / Отстраниться
  离去 → Уйти
  打死 → Забить до Смерти
  还手 → Дать Отпор
  请安 → Передать Привет
  掰走 → Отломить и Унести
  了断 → Разрешить / Покончить
  卷在 → Обвивать/Окутывать
  隔空 → Сквозь Пространство
  青蛇 → Лазурная Змея
  轰走 → Отбросить Взрывом
  逼退 → Отбросить Назад
  遥望 → Смотреть Издалека
  回缩 → Отступить / Сжаться
  降精 → Нисхождение Сущности
  握拳 → Сжать Кулак
  爆出 → Вырваться / Взорваться
  吸来 → Втянуть / Притянуть
  鞭影 → Тень Кнута
  抢夺 → Захват / Похищение
  爆喝 → Взрывной Крик
  淹没 → Погрузить / Затопить
  一笑 → Улыбнуться
  接下 → Принять / Выдержать
  撕噬 → Разрывать и Пожирать
  目睹 → Стать Свидетелем
  抹除 → Удалить / Стереть
  商议 → Обсуждать / Совещаться
  训斥 → Отчитывать / Ругать
  模仿 → Имитировать / Подражать
  抬脚 → Поднять Ногу
  跨越 → Преодолеть / Пересечь
  呼风 → Призыв Ветра
  退入 → Отступить Внутрь
  怒道 → Гневно Сказать
  驱鬼 → Изгнание Призраков
  吞魂 → Поглощение Душ
  掀天 → Переворачивание Небес
  拘出 → Извлечь/Вытащить
  魂面 → Лик Души

[simple_physical]
  巅峰的战兵之斩 → Удар Боевого Оружия Пикового Уровня

[short_generic]
  咬断 → Откусить/Перекусить
  退避 → Отступление/Уклонение
  咬碎 → Разгрызть/Разбить
  围猎 → Охота с Окружением
  云蟒 → Облачная Питон (проявление техники)
  黑龙 → Черный Дракон (проявление техники)
  融神 → Слияние Духа/Сознания
  围攻 → Окружить и Атаковать

[generic_combat]
  反杀 → Контратака / Убийство в Ответ

[short_generic]
  轰杀 → Разнести и Убить
  卷去 → Унести / Свернуть
  冲来 → Броситься/Устремиться
  长啸 → Долгий Свист/Крик
  拿下 → Снять / Взять
  甩开 → Отбросить / Отделаться
  土雷 → Земной Гром
  木雷 → Древесный Гром
  吸死 → Высосать до Смерти
  拼了 → Рискнуть Всем
  吊命 → Поддерживать Жизнь
  掰断 → Отломить / Переломить
  划过 → Скользнуть / Пронестись
  扶起 → Поднять / Поддержать
  抚过 → Провести Рукой / Погладить
  抓着 → Держать / Хватать
  快步 → Быстрый Шаг
  点出 → Указать
  掀起 → Поднять/Вызвать
  炸动 → Взрывать/Потрясать
  杀来 → Прийти Убивать
  一扫 → Один Взмах
  立威 → Установить Авторитет
  卷到 → Окутать / Накатиться
  死！ → Умри!
  绳索 → Веревка (как проявление техники)

[numbered_strikes]
  第二击 → Второй Удар

[short_generic]
  灭了 → Уничтожить
  滚回 → Откатиться Назад
  散入 → Рассеяться Внутрь
  漂升 → Парить Вверх
  爆起 → Взрывной Подъем
  带动 → Приводить в Движение / Стимулировать
  驱散 → Рассеять / Изгнать
  游荡 → Бродить / Скитаться
  化解 → Разрешить / Устранить
  低语 → Шептать / Бормотать
  留守 → Оставаться на Посту / Охранять
  突袭 → Внезапная Атака
  乱雾 → Хаотичный Туман
  人山 → Человеческая Гора
  地山 → Земная Гора

[generic_combat]
  一棒 → Один Удар Дубиной

[short_generic]
  死咒 → Смертельное Проклятие
  化四 → Превращается в Четыре
  出马 → Выйти на Сцену (идиома)
  一怔 → Застыть на Мгновение
  算准 → Точно Рассчитать
  缠斗 → Затяжная Битва
  一招 → Один Прием
  轰入 → С Грохотом Ворваться
  交战 → Вести Бой
  一凝 → Сфокусироваться / Сосредоточиться
  一甩 → Отбросить / Оттолкнуть
  抽动 → Двигать / Дергать
  冲刺 → Спринт / Рывок
  一缩 → Сжаться / Сузиться
  一捏 → Сжать / Щипнуть
  跪安 → Преклонить Колени и Удалиться
  速退 → Быстро Отступить
  替死 → Умереть Вместо
  拽回 → Тянуть Назад
  传下 → Передать Вниз
  飘起 → Взлететь / Подняться
  弹起 → Отскочить / Подпрыгнуть
  避战 → Избегать Битвы
  同战 → Сражаться Одновременно
  飞离 → Улететь
  闪断 → Мгновенный Разрыв
